Keyword	Python
chhapo	print
mahiti	input
jo	if
athva	else
kro	do
jya	while
mate	for
bahar	break
chalu	continue
ane	and
ya	or
khotu	false
sachu	true
nahi	not
banavo	def
moklo	return
prayas	try
sivay	except
kul	len
jodo	append
hatavo	pop
